9	352	138	2	0	9001	3	1	-1	-1	-1	5	5001	6011
9	1792	154	3	0	9001	2	1	-1	-1	-1	7	7001
9	1856	138	2	0	9001	3	1	-1	-1	-1	6	6001	6011
9	2256	-118	0	0	9001	12	1	1	2144	300
9	2256	154	3	0	9001	2	0	-1	-1	-1
9	2320	154	3	0	9001	2	1	-1	-1	-1
3	224	166	3	0	3001	0
3	528	170	3	0	3001	0
3	832	154	3	0	3001	0
3	880	154	3	0	3001	0
3	944	152	2	0	3002	1
4	576	122	2	0	4002	0
4	1328	63	2	0	4001	1
4	1376	63	2	0	4001	1
4	1424	63	2	0	4001	1
4	1472	159	3	0	4001	0
4	2100	127	2	0	4002	0
2	0	186	3	0	2001	1	39
2	624	170	3	0	20012	29
2	1152	186	3	0	2001	1	22
2	1536	186	3	0	2001	1	5
2	1664	186	3	0	2001	1	36
2	2256	186	3	0	2001	1	35
8	240	138	2	0	8002	3	3
8	272	106	2	0	8003	5	3
8	512	154	3	0	8001	2	6
8	400	138	2	0	8001	3	5
8	464	106	2	0	8002	5	4
8	512	74	2	0	8004	7	4
8	1264	154	3	0	8001	2	6
8	1296	122	2	0	8002	4	6
8	1328	90	2	0	8003	6	6
8	1312	-86	1	0	8002	2	4
8	2144	138	2	0	8002	3	3
8	2176	42	2	0	8001	9	3
1	1408	-38	1	0	10021	4
1	1488	-54	1	0	10021	13
1	1504	106	2	0	10011	2
1	1568	170	3	0	100111
1	1584	154	3	0	1001	21
1	1600	138	2	0	1001	31
1	1664	138	2	0	1001	31
1	1680	154	3	0	1001	21
1	1696	170	3	0	100111
1	2256	74	2	0	10011	2
1	2256	138	2	0	10011	2
0	50	154	3	0	101	102
12	1072	90	2	0	1201
12	1104	58	2	0	1201
12	1136	26	2	0	1201
12	1168	-6	1	0	1201
12	1200	-38	1	0	1201
12	1328	-150	0	0	1201
12	1344	-150	0	0	1201
12	1360	-150	0	0	1201
12	1472	-118	0	0	1201
12	1488	-118	0	0	1201
12	1536	-102	1	0	1201
12	1552	-102	1	0	1201
12	1568	-102	1	0	1201
12	1584	-102	1	0	1201
12	1616	-118	0	0	1201
12	1632	-118	0	0	1201
12	1648	-118	0	0	1201
12	1664	-118	0	0	1201
12	1696	-86	1	0	1201
12	1728	-118	0	0	1201
12	1760	-102	1	0	1201
12	1824	-134	0	0	1201
12	1856	-102	1	0	1201
11	1952	170	3	0	1101	1102	1201
11	1968	154	3	0	1101	1102	1201
11	1968	170	3	0	1101	1102	1201
11	1984	138	2	0	1101	1102	1201
11	1984	154	3	0	1101	1102	1201
11	1984	170	3	0	1101	1102	1201
11	2000	138	2	0	1101	1102	1201
11	2000	154	3	0	1101	1102	1201
11	2000	170	3	0	1101	1102	1201
11	2016	138	2	0	1101	1102	1201
11	2016	154	3	0	1101	1102	1201
11	2016	170	3	0	1101	1102	1201
11	2032	154	3	0	1101	1102	1201
11	2032	170	3	0	1101	1102	1201
11	2048	170	3	0	1101	1102	1201
11	2096	154	3	0	1101	1102	1201
11	2096	170	3	0	1101	1102	1201
11	2112	170	3	0	1101	1102	1201
10	176	122	2	0	10001	0	12	1201
10	192	122	2	0	10001	0	12	1201
10	224	74	2	0	10001	0	12	1201
10	240	74	2	0	10001	0	13	1301	0
10	416	90	2	0	10001	0	12	1201
10	656	154	3	0	10001	0	14	1401
10	704	122	2	0	10001	0	12	1201
10	1472	138	2	0	10001	0	14	1401
10	1440	-102	1	0	1101	0	13	1301	1
10	2032	138	2	0	1101	0	24	2400
21	2680	98	2	0	9700
1	1984	234	3	0	1003	12	8
1	2144	234	3	0	10031	12
1	2368	234	3	0	1003	12	8
1	2112	394	4	0	1003	2	8
1	2240	378	4	0	1003	31
1	2256	362	4	0	1003	41
1	2272	346	4	0	1003	51
1	2288	330	4	0	1003	61
1	2304	314	4	0	1003	71
1	2320	298	4	0	1003	8	3
9	2112	234	3	0	9002	2	2	-1	-1	-1
9	2336	234	3	0	9002	2	2	0	2332	126
12	2192	274	3	0	1201
12	2208	258	3	0	1201
12	2224	258	3	0	1201
12	2240	274	3	0	1201
12	2240	288	4	0	1201
12	2208	306	4	0	1201
12	2224	306	4	0	1201
12	2240	322	4	0	1201
12	2240	338	4	0	1201
12	2208	354	4	0	1201
12	2224	354	4	0	1201
12	2192	338	4	0	1201
