25	368	80	2	0	2501
25	592	64	1	0	2501
25	560	112	2	0	2501
25	624	160	4	0	2501
25	752	96	2	0	2501
25	1088	144	3	0	2501
25	1200	80	2	0	2501
25	1376	112	2	0	2501
25	1408	96	2	0	2501
25	1552	64	1	0	2501
25	1776	96	2	0	2501
25	1744	144	3	0	2501
25	1792	176	4	0	2501
9	1936	96	2	0	9001	4	1	1	112	2200
9	2192	144	3	0	9001	2	1	-1	-1	-1
4	1072	80	2	0	4002	0
4	1872	48	1	0	4002	2
4	1984	96	2	0	4002	0
0	50	80	2	0	101	102
2	2064	176	4	0	2001	1	32
8	1920	160	4	0	8006	28
8	0	112	2	0	8005	5	10
8	1968	128	3	0	8005	2	3
1	2032	0	0	0	1001	161
12	336	64	1	0	1201
12	352	64	1	0	1201
12	368	64	1	0	1201
12	416	32	0	0	1201
12	432	32	0	0	1201
12	448	32	0	0	1201
12	768	64	1	0	1201
12	784	64	1	0	1201
12	800	64	1	0	1201
12	848	32	0	0	1201
12	864	32	0	0	1201
12	880	32	0	0	1201
12	1328	48	1	0	1201
12	1344	48	1	0	1201
12	1360	48	1	0	1201
12	1504	32	0	0	1201
12	1504	48	1	0	1201
12	1504	64	1	0	1201
12	1504	80	2	0	1201
12	1504	96	2	0	1201
12	1504	112	2	0	1201
12	1504	128	3	0	1201
12	1504	144	3	0	1201
12	1888	64	1	0	1201
12	1904	64	1	0	1201
12	1920	64	1	0	1201
11	224	112	2	0	1101	1102	1201
11	240	112	2	0	1101	1102	1201
11	256	112	2	0	1101	1102	1201
11	272	112	2	0	1101	1102	1201
11	384	96	2	0	1101	1102	1201
11	400	96	2	0	1101	1102	1201
11	416	96	2	0	1101	1102	1201
11	432	96	2	0	1101	1102	1201
11	448	96	2	0	1101	1102	1201
11	640	128	3	0	1101	1102	1201
11	656	128	3	0	1101	1102	1201
11	752	80	2	0	1101	1102	1201
11	752	96	2	0	1101	1102	1201
11	752	112	2	0	1101	1102	1201
11	752	128	3	0	1101	1102	1201
11	768	128	3	0	1101	1102	1201
11	784	128	3	0	1101	1102	1201
11	800	128	3	0	1101	1102	1201
11	864	96	2	0	1101	1102	1201
11	864	112	2	0	1101	1102	1201
11	864	128	3	0	1101	1102	1201
11	864	144	3	0	1101	1102	1201
11	880	144	3	0	1101	1102	1201
11	896	144	3	0	1101	1102	1201
11	944	96	2	0	1101	1102	1201
11	944	112	2	0	1101	1102	1201
11	960	160	4	0	1101	1102	1201
11	976	160	4	0	1101	1102	1201
11	992	160	4	0	1101	1102	1201
11	1008	160	4	0	1101	1102	1201
11	1152	144	3	0	1101	1102	1201
11	1168	144	3	0	1101	1102	1201
11	1184	144	3	0	1101	1102	1201
11	1200	144	3	0	1101	1102	1201
11	1216	144	3	0	1101	1102	1201
11	1184	64	1	0	1101	1102	1201
11	1200	64	1	0	1101	1102	1201
11	1216	64	1	0	1101	1102	1201
11	1232	64	1	0	1101	1102	1201
11	1184	64	1	0	1101	1102	1201
11	1200	64	1	0	1101	1102	1201
11	1216	64	1	0	1101	1102	1201
11	1232	64	1	0	1101	1102	1201
11	1264	128	3	0	1101	1102	1201
11	1280	128	3	0	1101	1102	1201
11	1392	64	1	0	1101	1102	1201
11	1408	64	1	0	1101	1102	1201
11	1424	64	1	0	1101	1102	1201
11	1536	64	1	0	1101	1102	1201
11	1536	128	3	0	1101	1102	1201
11	1536	144	3	0	1101	1102	1201
11	1536	160	4	0	1101	1102	1201
11	1552	160	4	0	1101	1102	1201
11	1568	160	4	0	1101	1102	1201
11	1584	160	4	0	1101	1102	1201
11	1728	48	1	0	1101	1102	1201
11	1744	48	1	0	1101	1102	1201
11	1760	48	1	0	1101	1102	1201
11	1776	128	3	0	1101	1102	1201
11	1792	128	3	0	1101	1102	1201
11	1808	128	3	0	1101	1102	1201
10	640	48	1	0	1101	0	13	1301	1
10	608	48	1	0	1101	1
10	624	48	1	0	1101	1
10	656	48	1	0	1101	1
10	960	112	2	0	1101	0	14	1401
10	1008	112	2	0	1101	0	12	1201	12	1201	12	1201	12	1201	12	1201	12	1201	12	1201	12	1201	12	1201	12	1201	12	1201
10	1024	112	2	0	1101	1
10	1040	112	2	0	1101	1
10	1056	112	2	0	1101	1
10	1072	112	2	0	1101	1
10	1232	48	1	0	1101	0	13	1301	1
10	1536	48	1	0	1101	0	12	1201	12	1201	12	1201	12	1201	12	1201	12	1201	12	1201
26	2096	144	3	0	2601	2701
