# ========== MARIO ==========
0	50	80	101	102

# ========== COLORED BRICKS ============
8	0	112	8005	5	10
8	1968	128	8005	2	3

# ========== SQUARE BRICKS ============
# Square Brick Group - 1
11	224	112	1101	1102	1201
11	240	112	1101	1102	1201
11	256	112	1101	1102	1201
11	272	112	1101	1102	1201
# Square Brick Group - 2
11	384	96	1101	1102	1201
11	400	96	1101	1102	1201
11	416	96	1101	1102	1201
11	432	96	1101	1102	1201
11	448	96	1101	1102	1201
# Square Brick Group - 3
11	608	48	1101	1102	1201
11	624	48	1101	1102	1201
11	640	48	1101	1102	1201
11	656	48	1101	1102	1201
# Square Brick Group - 4
11	640	128	1101	1102	1201
11	656	128	1101	1102	1201
# Square Brick Group - 5
11	752	80	1101	1102	1201
11	752	96	1101	1102	1201
11	752	112	1101	1102	1201
11	752	128	1101	1102	1201
11	768	128	1101	1102	1201
11	784	128	1101	1102	1201
11	800	128	1101	1102	1201
# Square Brick Group - 6
11	864	96	1101	1102	1201
11	864	112	1101	1102	1201
11	864	128	1101	1102	1201
11	864	144	1101	1102	1201
11	880	144	1101	1102	1201
11	896	144	1101	1102	1201
# Square Brick Group - 7
11	944	96	1101	1102	1201
11	944	112	1101	1102	1201
11	960	112	1101	1102	1201
# Square Brick Group - 8
11	1008	112	1101	1102	1201
11	1024	112	1101	1102	1201
11	1040	112	1101	1102	1201
11	1056	112	1101	1102	1201
11	1072	112	1101	1102	1201
# Square Brick Group - 9
11	960	160	1101	1102	1201
11	976	160	1101	1102	1201
11	992	160	1101	1102	1201
11	1008	160	1101	1102	1201
# Square Brick Group - 10
11	1152	144	1101	1102	1201
11	1168	144	1101	1102	1201
11	1184	144	1101	1102	1201
11	1200	144	1101	1102	1201
11	1216	144	1101	1102	1201
# Square Brick Group - 11
11	1184	64	1101	1102	1201
11	1200	64	1101	1102	1201
11	1216	64	1101	1102	1201
11	1232	64	1101	1102	1201
# Square Brick Group - 12
11	1264	128	1101	1102	1201
11	1280	128	1101	1102	1201
# Square Brick Group - 13
11	1392	64	1101	1102	1201
11	1408	64	1101	1102	1201
11	1424	64	1101	1102	1201
# Square Brick Group - 14
11	1536	48	1101	1102	1201
11	1536	64	1101	1102	1201
# Square Brick Group - 15
11	1536	128	1101	1102	1201
11	1536	144	1101	1102	1201
11	1536	160	1101	1102	1201
11	1552	160	1101	1102	1201
11	1568	160	1101	1102	1201
11	1584	160	1101	1102	1201
# Square Brick Group - 16
11	1728	48	1101	1102	1201
11	1744	48	1101	1102	1201
11	1760	48	1101	1102	1201
# Square Brick Group - 17
11	1776	128	1101	1102	1201
11	1792	128	1101	1102	1201
11	1808	128	1101	1102	1201