25	368.000000	80.000000	0	2	2501
25	592.000000	64.000000	0	2	2501
25	560.000000	112.000000	0	2	2501
25	624.000000	160.000000	0	3	2501
25	752.000000	96.000000	0	2	2501
25	1088.000000	144.000000	0	2	2501
25	1200.000000	80.000000	0	2	2501
25	1376.000000	112.000000	0	2	2501
25	1408.000000	96.000000	0	2	2501
25	1552.000000	64.000000	0	2	2501
25	1776.000000	96.000000	0	2	2501
25	1744.000000	144.000000	0	2	2501
25	1792.000000	176.000000	0	3	2501
9	1936.000000	96.000000	0	2	9001	4	1	1	112	2200
9	2192.000000	144.000000	0	2	9001	2	1	-1	-1	-1
4	1072.000000	80.000000	0	2	4002	0
4	1872.000000	48.000000	0	2	4002	2
4	1984.000000	96.000000	0	2	4002	0
0	50.000000	80.000000	0	2	101	102
2	2064.000000	176.000000	0	3	2001	0
2	2080.000000	176.000000	0	3	2001	2
2	2096.000000	176.000000	0	3	2001	2
2	2112.000000	176.000000	0	3	2001	2
2	2128.000000	176.000000	0	3	2001	2
2	2144.000000	176.000000	0	3	2001	2
2	2160.000000	176.000000	0	3	2001	2
2	2176.000000	176.000000	0	3	2001	2
2	2192.000000	176.000000	0	3	2001	2
2	2208.000000	176.000000	0	3	2001	2
2	2224.000000	176.000000	0	3	2001	2
2	2240.000000	176.000000	0	3	2001	2
2	2256.000000	176.000000	0	3	2001	2
2	2272.000000	176.000000	0	3	2001	2
2	2288.000000	176.000000	0	3	2001	2
2	2304.000000	176.000000	0	3	2001	2
2	2320.000000	176.000000	0	3	2001	2
2	2336.000000	176.000000	0	3	2001	2
2	2352.000000	176.000000	0	3	2001	2
2	2368.000000	176.000000	0	3	2001	2
2	2384.000000	176.000000	0	3	2001	2
2	2400.000000	176.000000	0	3	2001	2
2	2416.000000	176.000000	0	3	2001	2
2	2432.000000	176.000000	0	3	2001	2
2	2448.000000	176.000000	0	3	2001	2
2	2464.000000	176.000000	0	3	2001	2
2	2480.000000	176.000000	0	3	2001	2
2	2496.000000	176.000000	0	3	2001	2
2	2512.000000	176.000000	0	3	2001	2
2	2528.000000	176.000000	0	3	2001	2
2	2544.000000	176.000000	0	3	2001	2
2	2560.000000	176.000000	0	3	2001	4
8	1920.000000	160.000000	0	3	8006	0
8	1936.000000	160.000000	0	3	8006	1
8	1952.000000	160.000000	0	3	8006	1
8	1968.000000	160.000000	0	3	8006	1
8	1984.000000	160.000000	0	3	8006	1
8	2000.000000	160.000000	0	3	8006	1
8	2016.000000	160.000000	0	3	8006	1
8	2032.000000	160.000000	0	3	8006	2
8	1920.000000	176.000000	0	3	8006	6
8	1936.000000	176.000000	0	3	8006	7
8	1952.000000	176.000000	0	3	8006	7
8	1968.000000	176.000000	0	3	8006	7
8	1984.000000	176.000000	0	3	8006	7
8	2000.000000	176.000000	0	3	8006	7
8	2016.000000	176.000000	0	3	8006	7
8	2032.000000	176.000000	0	3	8006	8
8	0.000000	112.000000	0	2	8005	0
8	16.000000	112.000000	0	2	8005	1
8	32.000000	112.000000	0	2	8005	1
8	48.000000	112.000000	0	2	8005	1
8	64.000000	112.000000	0	2	8005	1
8	80.000000	112.000000	0	2	8005	1
8	96.000000	112.000000	0	2	8005	1
8	112.000000	112.000000	0	2	8005	1
8	128.000000	112.000000	0	2	8005	1
8	144.000000	112.000000	0	2	8005	2
8	0.000000	128.000000	0	2	8005	3
8	16.000000	128.000000	0	2	8005	4
8	32.000000	128.000000	0	2	8005	4
8	48.000000	128.000000	0	2	8005	4
8	64.000000	128.000000	0	2	8005	4
8	80.000000	128.000000	0	2	8005	4
8	96.000000	128.000000	0	2	8005	4
8	112.000000	128.000000	0	2	8005	4
8	128.000000	128.000000	0	2	8005	4
8	144.000000	128.000000	0	2	8005	5
8	0.000000	144.000000	0	2	8005	3
8	16.000000	144.000000	0	2	8005	4
8	32.000000	144.000000	0	2	8005	4
8	48.000000	144.000000	0	2	8005	4
8	64.000000	144.000000	0	2	8005	4
8	80.000000	144.000000	0	2	8005	4
8	96.000000	144.000000	0	2	8005	4
8	112.000000	144.000000	0	2	8005	4
8	128.000000	144.000000	0	2	8005	4
8	144.000000	144.000000	0	2	8005	5
8	0.000000	160.000000	0	3	8005	3
8	16.000000	160.000000	0	3	8005	4
8	32.000000	160.000000	0	3	8005	4
8	48.000000	160.000000	0	3	8005	4
8	64.000000	160.000000	0	3	8005	4
8	80.000000	160.000000	0	3	8005	4
8	96.000000	160.000000	0	3	8005	4
8	112.000000	160.000000	0	3	8005	4
8	128.000000	160.000000	0	3	8005	4
8	144.000000	160.000000	0	3	8005	5
8	0.000000	176.000000	0	3	8005	6
8	16.000000	176.000000	0	3	8005	7
8	32.000000	176.000000	0	3	8005	7
8	48.000000	176.000000	0	3	8005	7
8	64.000000	176.000000	0	3	8005	7
8	80.000000	176.000000	0	3	8005	7
8	96.000000	176.000000	0	3	8005	7
8	112.000000	176.000000	0	3	8005	7
8	128.000000	176.000000	0	3	8005	7
8	144.000000	176.000000	0	3	8005	8
8	1968.000000	128.000000	0	2	8005	0
8	1984.000000	128.000000	0	2	8005	1
8	2000.000000	128.000000	0	2	8005	2
8	1968.000000	144.000000	0	2	8005	6
8	1984.000000	144.000000	0	2	8005	7
8	2000.000000	144.000000	0	2	8005	8
1	2032.000000	0.000000	0	1	1001
1	2032.000000	16.000000	0	1	1001
1	2032.000000	32.000000	0	2	1001
1	2032.000000	48.000000	0	2	1001
1	2032.000000	64.000000	0	2	1001
1	2032.000000	80.000000	0	2	1001
1	2032.000000	96.000000	0	2	1001
1	2032.000000	112.000000	0	2	1001
1	2032.000000	128.000000	0	2	1001
1	2032.000000	144.000000	0	2	1001
1	2032.000000	160.000000	0	3	1001
1	2032.000000	176.000000	0	3	1001
1	2032.000000	192.000000	0	3	1001
1	2032.000000	208.000000	0	3	1001
1	2032.000000	224.000000	0	3	1001
1	2032.000000	240.000000	0	3	1001
12	336.000000	64.000000	0	2	1201
12	352.000000	64.000000	0	2	1201
12	368.000000	64.000000	0	2	1201
12	416.000000	32.000000	0	2	1201
12	432.000000	32.000000	0	2	1201
12	448.000000	32.000000	0	2	1201
12	768.000000	64.000000	0	2	1201
12	784.000000	64.000000	0	2	1201
12	800.000000	64.000000	0	2	1201
12	848.000000	32.000000	0	2	1201
12	864.000000	32.000000	0	2	1201
12	880.000000	32.000000	0	2	1201
12	1328.000000	48.000000	0	2	1201
12	1344.000000	48.000000	0	2	1201
12	1360.000000	48.000000	0	2	1201
12	1504.000000	32.000000	0	2	1201
12	1504.000000	48.000000	0	2	1201
12	1504.000000	64.000000	0	2	1201
12	1504.000000	80.000000	0	2	1201
12	1504.000000	96.000000	0	2	1201
12	1504.000000	112.000000	0	2	1201
12	1504.000000	128.000000	0	2	1201
12	1504.000000	144.000000	0	2	1201
12	1888.000000	64.000000	0	2	1201
12	1904.000000	64.000000	0	2	1201
12	1920.000000	64.000000	0	2	1201
11	224.000000	112.000000	0	2	1101	1102	1201
11	240.000000	112.000000	0	2	1101	1102	1201
11	256.000000	112.000000	0	2	1101	1102	1201
11	272.000000	112.000000	0	2	1101	1102	1201
11	384.000000	96.000000	0	2	1101	1102	1201
11	400.000000	96.000000	0	2	1101	1102	1201
11	416.000000	96.000000	0	2	1101	1102	1201
11	432.000000	96.000000	0	2	1101	1102	1201
11	448.000000	96.000000	0	2	1101	1102	1201
11	640.000000	128.000000	0	2	1101	1102	1201
11	656.000000	128.000000	0	2	1101	1102	1201
11	752.000000	80.000000	0	2	1101	1102	1201
11	752.000000	96.000000	0	2	1101	1102	1201
11	752.000000	112.000000	0	2	1101	1102	1201
11	752.000000	128.000000	0	2	1101	1102	1201
11	768.000000	128.000000	0	2	1101	1102	1201
11	784.000000	128.000000	0	2	1101	1102	1201
11	800.000000	128.000000	0	2	1101	1102	1201
11	864.000000	96.000000	0	2	1101	1102	1201
11	864.000000	112.000000	0	2	1101	1102	1201
11	864.000000	128.000000	0	2	1101	1102	1201
11	864.000000	144.000000	0	2	1101	1102	1201
11	880.000000	144.000000	0	2	1101	1102	1201
11	896.000000	144.000000	0	2	1101	1102	1201
11	944.000000	96.000000	0	2	1101	1102	1201
11	944.000000	112.000000	0	2	1101	1102	1201
11	960.000000	160.000000	0	3	1101	1102	1201
11	976.000000	160.000000	0	3	1101	1102	1201
11	992.000000	160.000000	0	3	1101	1102	1201
11	1008.000000	160.000000	0	3	1101	1102	1201
11	1152.000000	144.000000	0	2	1101	1102	1201
11	1168.000000	144.000000	0	2	1101	1102	1201
11	1184.000000	144.000000	0	2	1101	1102	1201
11	1200.000000	144.000000	0	2	1101	1102	1201
11	1216.000000	144.000000	0	2	1101	1102	1201
11	1184.000000	64.000000	0	2	1101	1102	1201
11	1200.000000	64.000000	0	2	1101	1102	1201
11	1216.000000	64.000000	0	2	1101	1102	1201
11	1232.000000	64.000000	0	2	1101	1102	1201
11	1184.000000	64.000000	0	2	1101	1102	1201
11	1200.000000	64.000000	0	2	1101	1102	1201
11	1216.000000	64.000000	0	2	1101	1102	1201
11	1232.000000	64.000000	0	2	1101	1102	1201
11	1264.000000	128.000000	0	2	1101	1102	1201
11	1280.000000	128.000000	0	2	1101	1102	1201
11	1392.000000	64.000000	0	2	1101	1102	1201
11	1408.000000	64.000000	0	2	1101	1102	1201
11	1424.000000	64.000000	0	2	1101	1102	1201
11	1536.000000	64.000000	0	2	1101	1102	1201
11	1536.000000	128.000000	0	2	1101	1102	1201
11	1536.000000	144.000000	0	2	1101	1102	1201
11	1536.000000	160.000000	0	3	1101	1102	1201
11	1552.000000	160.000000	0	3	1101	1102	1201
11	1568.000000	160.000000	0	3	1101	1102	1201
11	1584.000000	160.000000	0	3	1101	1102	1201
11	1728.000000	48.000000	0	2	1101	1102	1201
11	1744.000000	48.000000	0	2	1101	1102	1201
11	1760.000000	48.000000	0	2	1101	1102	1201
11	1776.000000	128.000000	0	2	1101	1102	1201
11	1792.000000	128.000000	0	2	1101	1102	1201
11	1808.000000	128.000000	0	2	1101	1102	1201
10	640.000000	48.000000	0	2	1101	0	13	1301	1
10	608.000000	48.000000	0	2	1101	1
10	624.000000	48.000000	0	2	1101	1
10	656.000000	48.000000	0	2	1101	1
10	960.000000	112.000000	0	2	1101	0	14	1401
10	1008.000000	112.000000	0	2	1101	0	12	1201	12	1201	12	1201	12	1201	12	1201	12	1201	12	1201	12	1201	12	1201	12	1201	12	1201
10	1024.000000	112.000000	0	2	1101	1
10	1040.000000	112.000000	0	2	1101	1
10	1056.000000	112.000000	0	2	1101	1
10	1072.000000	112.000000	0	2	1101	1
10	1232.000000	48.000000	0	2	1101	0	13	1301	1
10	1536.000000	48.000000	0	2	1101	0	12	1201	12	1201	12	1201	12	1201	12	1201	12	1201	12	1201
26	2096.000000	144.000000	0	2	2601	2701
