# =========== FLOATING BLOCKS =============
25	368	80	2501
25	592	64	2501
25	560	112	2501
25	624	160	2501
25	752	96	2501
25	1088	144	2501
25	1200	80	2501
25	1376	112	2501
25	1408	96	2501
25	1552	64	2501
25	1776	96	2501
25	1744	144	2501
25	1792	176	2501

# ========== TUBES ==========
9	1936	96	9001	4	1	1	2200	112
9	2192	144	9001	2	1	-1	-1	-1

# ========== KOOPAS ==========
4	1072	80	4002	0
4	1872	48	4002	2
4	1984	96	4002	0

# ========== MARIO ==========
0	50	80	101	102

# ============== PLATFORM ===============
2	2064	176	2001	1	32

# ========== COLORED BRICKS ============
8	1920	160	8006	2	8
8	0	112	8005	5	10
8	1968	128	8005	2	3

# ============== BRICKS ===================
1	2032	0	1001	16	1

# ============== COINS ====================
# Coin Group - 1
12	336	64	1201
12	352	64	1201
12	368	64	1201
# Coin Group - 2
12	416	32	1201
12	432	32	1201
12	448	32	1201
# Coin Group - 3
12	768	64	1201
12	784	64	1201
12	800	64	1201
# Coin Group - 4
12	848	32	1201
12	864	32	1201
12	880	32	1201
# Coin Group - 5
12	1328	48	1201
12	1344	48	1201
12	1360	48	1201
# Coin Group - 6
12	1504	32	1201
12	1504	48	1201
12	1504	64	1201
12	1504	80	1201
12	1504	96	1201
12	1504	112	1201
12	1504	128	1201
12	1504	144	1201
# Coin Group - 7
12	1888	64	1201
12	1904	64	1201
12	1920	64	1201

# ========== SQUARE BRICKS ============
# Square Brick Group - 1
11	224	112	1101	1102	1201
11	240	112	1101	1102	1201
11	256	112	1101	1102	1201
11	272	112	1101	1102	1201
# Square Brick Group - 2
11	384	96	1101	1102	1201
11	400	96	1101	1102	1201
11	416	96	1101	1102	1201
11	432	96	1101	1102	1201
11	448	96	1101	1102	1201
# Square Brick Group - 3
# Square Brick Group - 4
11	640	128	1101	1102	1201
11	656	128	1101	1102	1201
# Square Brick Group - 5
11	752	80	1101	1102	1201
11	752	96	1101	1102	1201
11	752	112	1101	1102	1201
11	752	128	1101	1102	1201
11	768	128	1101	1102	1201
11	784	128	1101	1102	1201
11	800	128	1101	1102	1201
# Square Brick Group - 6
11	864	96	1101	1102	1201
11	864	112	1101	1102	1201
11	864	128	1101	1102	1201
11	864	144	1101	1102	1201
11	880	144	1101	1102	1201
11	896	144	1101	1102	1201
# Square Brick Group - 7
11	944	96	1101	1102	1201
11	944	112	1101	1102	1201
# Square Brick Group - 8
# Square Brick Group - 9
11	960	160	1101	1102	1201
11	976	160	1101	1102	1201
11	992	160	1101	1102	1201
11	1008	160	1101	1102	1201
# Square Brick Group - 10
11	1152	144	1101	1102	1201
11	1168	144	1101	1102	1201
11	1184	144	1101	1102	1201
11	1200	144	1101	1102	1201
11	1216	144	1101	1102	1201
# Square Brick Group - 11
11	1184	64	1101	1102	1201
11	1200	64	1101	1102	1201
11	1216	64	1101	1102	1201
11	1232	64	1101	1102	1201
# Square Brick Group - 12
11	1184	64	1101	1102	1201
11	1200	64	1101	1102	1201
11	1216	64	1101	1102	1201
11	1232	64	1101	1102	1201
# Square Brick Group - 13
11	1264	128	1101	1102	1201
11	1280	128	1101	1102	1201
# Square Brick Group - 14
11	1392	64	1101	1102	1201
11	1408	64	1101	1102	1201
11	1424	64	1101	1102	1201
# Square Brick Group - 15
11	1536	64	1101	1102	1201
# Square Brick Group - 16
11	1536	128	1101	1102	1201
11	1536	144	1101	1102	1201
11	1536	160	1101	1102	1201
11	1552	160	1101	1102	1201
11	1568	160	1101	1102	1201
11	1584	160	1101	1102	1201
# Square Brick Group - 17
11	1728	48	1101	1102	1201
11	1744	48	1101	1102	1201
11	1760	48	1101	1102	1201
# Square Brick Group - 18
11	1776	128	1101	1102	1201
11	1792	128	1101	1102	1201
11	1808	128	1101	1102	1201

# ============ QUESTION BRICKS =============
10	640	48	1101	0	13	1301	1
10	608	48	1101	1
10	624	48	1101	1
10	656	48	1101	1
10	960	112	1101	0	14	1401
10	1008	112	1101	0	12	1201	12	1201	12	1201	12	1201	12	1201	12	1201	12	1201	12	1201	12	1201	12	1201	12	1201
10	1024	112	1101	1
10	1040	112	1101	1
10	1056	112	1101	1
10	1072	112	1101	1
10	1232	48	1101	0	13	1301	1
10	1536	48	1101	0	12	1201	12	1201	12	1201	12	1201	12	1201	12	1201	12	1201

# ============ Boomerang Bro ===============
26	2096	144	2601	2701