48	48	48	51	1	14	1	14	1	14	1	14	48	48
48	48	48	2	48	48	48	2	48	48	48	2	48	48
1	14	1	24	48	48	48	22	1	14	1	24	48	48
48	48	48	17	48	48	48	2	48	48	48	48	48	48
48	48	48	22	1	14	1	24	48	48	36	38	37	48
48	48	48	2	48	48	48	48	36	38	40	34	35	48
48	48	42	22	42	14	1	14	41	14	1	50	35	48
48	42	42	2	42	42	48	2	35	48	48	48	35	48
48	42	42	22	1	14	1	24	39	38	38	38	40	48